"filename", "language", "XML", "Java", "comment", "blank", "total"
"/home/qibin/Documents/learnsource/Source/java/TwentyFour/pom.xml", "XML", 70, 0, 4, 7, 81
"/home/qibin/Documents/learnsource/Source/java/TwentyFour/src/main/java/TwentyFour/ClientDate.java", "Java", 0, 34, 0, 9, 43
"/home/qibin/Documents/learnsource/Source/java/TwentyFour/src/main/java/TwentyFour/DateParser.java", "Java", 0, 139, 0, 48, 187
"/home/qibin/Documents/learnsource/Source/java/TwentyFour/src/main/java/TwentyFour/Logic.java", "Java", 0, 271, 43, 51, 365
"/home/qibin/Documents/learnsource/Source/java/TwentyFour/src/main/java/TwentyFour/Server.java", "Java", 0, 39, 2, 9, 50
"/home/qibin/Documents/learnsource/Source/java/TwentyFour/src/main/java/TwentyFour/WinDialog.java", "Java", 0, 15, 0, 5, 20
"/home/qibin/Documents/learnsource/Source/java/TwentyFour/src/main/java/TwentyFour/bottom.java", "Java", 0, 17, 0, 5, 22
"/home/qibin/Documents/learnsource/Source/java/TwentyFour/src/main/java/TwentyFour/initApp.java", "Java", 0, 31, 34, 18, 83
"/home/qibin/Documents/learnsource/Source/java/TwentyFour/src/main/java/TwentyFour/left.java", "Java", 0, 9, 0, 3, 12
"/home/qibin/Documents/learnsource/Source/java/TwentyFour/src/main/java/TwentyFour/middle.java", "Java", 0, 195, 81, 52, 328
"/home/qibin/Documents/learnsource/Source/java/TwentyFour/src/main/java/TwentyFour/right.java", "Java", 0, 14, 0, 1, 15
"/home/qibin/Documents/learnsource/Source/java/TwentyFour/src/main/java/TwentyFour/typeButton.java", "Java", 0, 15, 26, 10, 51
"/home/qibin/Documents/learnsource/Source/java/TwentyFour/src/test/java/TwentyFour/AppTest.java", "Java", 0, 10, 23, 9, 42
"/home/qibin/Documents/learnsource/Source/java/TwentyFour/流程图.svg", "XML", 5, 0, 0, 0, 5
"Total", "-", 75, 789, 213, 227, 1304