"filename", "language", "XML", "Java", "comment", "blank", "total"
"/home/qibin/Documents/learnsource/Source/java/TwentyFour/pom.xml", "XML", 70, 0, 4, 7, 81
"/home/qibin/Documents/learnsource/Source/java/TwentyFour/src/main/java/TwentyFour/ClientDate.java", "Java", 0, 34, 0, 9, 43
"/home/qibin/Documents/learnsource/Source/java/TwentyFour/src/main/java/TwentyFour/DateParser.java", "Java", 0, 123, 0, 42, 165
"/home/qibin/Documents/learnsource/Source/java/TwentyFour/src/main/java/TwentyFour/Logic.java", "Java", 0, 3, 0, 2, 5
"/home/qibin/Documents/learnsource/Source/java/TwentyFour/src/main/java/TwentyFour/Server.java", "Java", 0, 25, 1, 6, 32
"/home/qibin/Documents/learnsource/Source/java/TwentyFour/src/main/java/TwentyFour/bottom.java", "Java", 0, 14, 0, 4, 18
"/home/qibin/Documents/learnsource/Source/java/TwentyFour/src/main/java/TwentyFour/initApp.java", "Java", 0, 50, 9, 17, 76
"/home/qibin/Documents/learnsource/Source/java/TwentyFour/src/main/java/TwentyFour/left.java", "Java", 0, 9, 0, 3, 12
"/home/qibin/Documents/learnsource/Source/java/TwentyFour/src/main/java/TwentyFour/middle.java", "Java", 0, 145, 82, 47, 274
"/home/qibin/Documents/learnsource/Source/java/TwentyFour/src/main/java/TwentyFour/right.java", "Java", 0, 9, 0, 2, 11
"/home/qibin/Documents/learnsource/Source/java/TwentyFour/src/main/java/TwentyFour/typeButton.java", "Java", 0, 12, 0, 4, 16
"/home/qibin/Documents/learnsource/Source/java/TwentyFour/src/test/java/TwentyFour/AppTest.java", "Java", 0, 23, 10, 9, 42
"/home/qibin/Documents/learnsource/Source/java/TwentyFour/target/classes/TwentyFour/BottomPanel.class", "Java", 0, 16, 0, 0, 16
"/home/qibin/Documents/learnsource/Source/java/TwentyFour/target/classes/TwentyFour/Card.class", "Java", 0, 10, 5, 0, 15
"/home/qibin/Documents/learnsource/Source/java/TwentyFour/target/classes/TwentyFour/CardContainer.class", "Java", 0, 15, 0, 0, 15
"/home/qibin/Documents/learnsource/Source/java/TwentyFour/target/classes/TwentyFour/CardPanel.class", "Java", 0, 19, 0, 0, 19
"/home/qibin/Documents/learnsource/Source/java/TwentyFour/target/classes/TwentyFour/ClientDate.class", "Java", 0, 9, 0, 0, 9
"/home/qibin/Documents/learnsource/Source/java/TwentyFour/target/classes/TwentyFour/DateParser.class", "Java", 0, 19, 0, 0, 19
"/home/qibin/Documents/learnsource/Source/java/TwentyFour/target/classes/TwentyFour/InitVs$PreCards.class", "Java", 0, 11, 0, 0, 11
"/home/qibin/Documents/learnsource/Source/java/TwentyFour/target/classes/TwentyFour/InitVs.class", "Java", 0, 23, 0, 0, 23
"/home/qibin/Documents/learnsource/Source/java/TwentyFour/target/classes/TwentyFour/LeftPanel.class", "Java", 0, 13, 0, 0, 13
"/home/qibin/Documents/learnsource/Source/java/TwentyFour/target/classes/TwentyFour/Logic.class", "Java", 0, 6, 0, 0, 6
"/home/qibin/Documents/learnsource/Source/java/TwentyFour/target/classes/TwentyFour/MiddlePanel.class", "Java", 0, 9, 0, 0, 9
"/home/qibin/Documents/learnsource/Source/java/TwentyFour/target/classes/TwentyFour/PlayerPanel.class", "Java", 0, 20, 4, 0, 24
"/home/qibin/Documents/learnsource/Source/java/TwentyFour/target/classes/TwentyFour/RightPanel.class", "Java", 0, 13, 0, 0, 13
"/home/qibin/Documents/learnsource/Source/java/TwentyFour/target/classes/TwentyFour/SendCard.class", "Java", 0, 16, 0, 0, 16
"/home/qibin/Documents/learnsource/Source/java/TwentyFour/target/classes/TwentyFour/Server.class", "Java", 0, 15, 0, 0, 15
"/home/qibin/Documents/learnsource/Source/java/TwentyFour/target/classes/TwentyFour/initApp$1.class", "Java", 0, 14, 0, 0, 14
"/home/qibin/Documents/learnsource/Source/java/TwentyFour/target/classes/TwentyFour/initApp.class", "Java", 0, 35, 0, 0, 35
"/home/qibin/Documents/learnsource/Source/java/TwentyFour/target/classes/TwentyFour/requestCard.class", "Java", 0, 9, 0, 0, 9
"/home/qibin/Documents/learnsource/Source/java/TwentyFour/target/classes/TwentyFour/typeButton.class", "Java", 0, 12, 0, 0, 12
"/home/qibin/Documents/learnsource/Source/java/TwentyFour/target/surefire-reports/TEST-TwentyFour.AppTest.xml", "XML", 62, 0, 0, 0, 62
"/home/qibin/Documents/learnsource/Source/java/TwentyFour/target/test-classes/TwentyFour/AppTest.class", "Java", 0, 21, 0, 1, 22
"/home/qibin/Documents/learnsource/Source/java/TwentyFour/流程图.svg", "XML", 5, 0, 0, 0, 5
"Total", "-", 137, 752, 115, 153, 1157